----------------------
----------------------
----------------------
---1111111111111111---
---1000000000000001---
---1000000000000001---
---1001111111111001---
---1001--------1001---
---1001--------1001---
---1001--------1001---
---1001-----1111001---
---1001-----1000001---
---1001111111000001---
---1000000000000001---
---1000000000000001---
---1111111111000001---
------------1111111---
----------------------
----------------------
----------------------