00000000000000000
00000011111000000
00000022222000000
00000011111000000
00000022222000000
00000011111000000
00000000000000000