----------------------
----------------------
----------------------
---2222222222222222---
---2111111111111112---
---2111111111111112---
---2112222222222112---
---2112--------2112---
---2112--------2112---
---2112--------2112---
---2112-----2222112---
---2112-----2111112---
---2112222222111112---
---2111111111111112---
---2111111111111112---
---2222222222111112---
------------2222222---
----------------------
----------------------
----------------------